NO ./assets/no.xpm
SO ./assets/so.xpm
WE ./assets/we.xpm
EA ./assets/ea.xpm
F 70,70,70
C 170,190,210

11111111111111111111
1N000000000000000001
10000011111000000001
10000010001000000001
10111110001110000001
10000000000000000001
10011111111100000001
10010000000100000001
10010111110100000001
10010000000100000001
10000000000000000001
11111111111111111111

