NO ./textures/north.xpm
SO ./textures/south.xpm
WE ./textures/west.xpm
EA ./textures/east.xpm
F 40,40,40
C 200,210,230

11111111111
1E000000011
10111011101
10001000001
10101011101
10000000001
11111111111

