NO ./textures/no.xpm
SO ./textures/so.xpm
WE ./textures/we.xpm
EA ./textures/ea.xpm
F 110,110,110
C 180,200,255

11111111
1N000011
10000011
11111111

