NO ./assets/no.xpm
SO ./assets/so.xpm
WE ./assets/we.xpm
EA ./assets/ea.xpm
F 80,70,60
C 160,180,200

111111111111111111
1N0000001110000001
100000001010000001
101111101010111101
100000001010000001
100011111110000001
100010000000000001
111110111111111101
100000100000000001
111111111111111111

