NO ./textures/north.xpm
SO ./textures/south.xpm
WE ./textures/west.xpm
EA ./textures/east.xpm
F 80,80,80
C 180,180,220

111111
1N0011
1111

