NO ./assets/no.xpm
SO ./assets/so.xpm
WE ./assets/we.xpm
EA ./assets/ea.xpm
F 0,0,0
C 180,180,220

111111111
100000001
100E00001
100000001
111111111

