NO ./textures/north.xpm
SO ./textures/south.xpm
WE ./textures/west.xpm
EA ./textures/east.xpm
F 0,0,0
C 180,180,220

111111111
100000001
100W00001
100000001
111111111

