NO ./textures/no.xpm
SO ./textures/so.xpm
WE ./textures/we.xpm
EA ./textures/ea.xpm
F 100,100,100
C 200,200,200

1111111
1N0  11
1111111

