NO ./assets/no.xpm
SO ./assets/so.xpm
WE ./assets/we.xpm
EA ./assets/ea.xpm
F 50,50,50
C 210,210,210

111111
1N0001
1000E1
111111

