NO ./textures/no.xpm
SO ./textures/so.xpm
WE ./textures/we.xpm
EA ./textures/ea.xpm
F 30,30,30
C 220,220,220

11111
10001
10001
11111

