NO ./assets/no.xpm
SO ./assets/so.xpm
WE ./assets/we.xpm
EA ./assets/ea.xpm
F 70,70,70
C 190,190,190

111111
1N0201
111111

