NO ./textures/north.xpm
SO ./textures/south.xpm
WE ./textures/west.xpm
EA ./textures/east.xpm
F -1,50,50
C 200,200,200

111111
1N0001
111111

