NO ./assets/no.xpm
SO ./assets/so.xpm
WE ./assets/we.xpm
EA ./assets/ea.xpm
F 10;20;30
C 100,100,100

1111
1N01
1111

