NO ./assets/not_found.xpm
SO ./assets/so.xpm
WE ./assets/we.xpm
EA ./assets/ea.xpm
F 90,90,90
C 150,150,200

111111
1N0001
111111

