NO ./textures/no.xpm
SO ./textures/so.xpm
WE ./textures/we.xpm
EA ./textures/ea.xpm
F 80,80,80
C 180,180,180

11111
1N001

11111

