NO ./textures/no.xpm
SO ./textures/so.xpm
WE ./textures/we.xpm
EA ./textures/ea.xpm
F 100,100,100
C 200,200,200

11111
1N001
11111
TRASH_AFTER_MAP

